Mambai	English
Bondia.	Good morning.
Botarde.	Good afternoon.
Bonoite.	Good night.
Kode ne bakode?	How are you?
Au kode kek.	Well, thanks.
It sul menbae, kode?	And how are you?
Adeus.	Goodbye.
Ate amanán.	See you tomorrow.
Ra kode!	That's good!
Parabeins!	Congratulations!
Kode hur-hur!	Get well soon!
Favor id.	Please.
Balikan tou sul ra.	Thank you.
Sam rae pun tama.	Thank you very much.
Nei.	Don't mention it.
Konlisensa.	There is/are.
Au tug deskulpa.	There isn't/are not
O leb pun favor id?	Is it all right?
Au leb tio?	May I go?
Favor né ma au/am ...	Please give me/us ...
Favor id ôd mêt au/am ...	Please also bring me/us ....
Favor id ajuda au.	Please help me!
Favor hur-hur.	Please hurry!
Ra importante.	It's important.
Ra urjente.	It's urgent.
Au ba leb.	I can't.
Leb mendai?	Is it possible?
Ba leb mendá.	It's not possible.
Au sente kole dlo.	I'm (very) tired.
Au beli.	I'm hungry.
Au mro.	I'm thirsty.
Au moras mededa klao.	I am (very) sick.
Ôd bal au tio doutór.	Take me to a doctor.
ôd au tio ospitál.	Take me to a hospital.
Herbae ...?	Where is the ...?
Pe rai.	Here you are.
Au ba tad.	I don't know.
Au ba komprende kid.	I don't understand.
It tad ne tais?	Do you understand?
It tad sapid pe au tou?	Do you see what I mean?
Balikan hanoin niri.	Don't worry.
Id-rai au boi.	I don't want this.
Au ba gosta rai.	I don't like this.
O gio ne?	Do you want it (some)?
Tabár me au ...	Show me ...
Mendai (mendá).	Like this (in this way).
Ma nei rai!	Come here!
Sai ôs rai!	Go away!
Gnan minutu kid lia!	Just a minute!
Favor id tabae ma.	Please come in.
Au os ba nei.	I have no money.
Au osa ba dai.	I don't have enough money.
Balikan dlai au!	Don't bother me!
Para balikan tiru!	Stop! Don't shoot!
Au glae kek...id.	I'm looking for a ....
Au la hah poh'sia ma.	I will call the police.
Amupadre herbae?	Where is the priest?
Deskulpa: au ba plig It.	Excuse me: I didn't hear you.
Favor id leb tou hat id loi?	Would you repeat that, please?
Menbae men It leb hah rai (ra) nei mambae?	What do you call this (that) in Mambai?
Artúb seri gase ingles (portugés, indonézia) nei rai?	Is there anyone here who speaks English? (Portuguese? Indonesian?)
It tradús bal rai ma au?	Can you translate this for me?
It leb durubasa (interpreta)?	Will you please interpret?
Favor id tabár kek ma au . Fraze rai nei livru.	Please point to the word (The phrase) in this book.
Gnan bal katkene: Au glae fraze nei livru.	Just a minute, I'll look for the word in the book.
It hei kana ma ôs bae?	Where have you arrived from?
Au hei kana ma ôs Darwin.	I have arrived from Darwin.
Au ma tel nei Timor sôp ma ôs Bali (Jakarta).	I've come to East Timor via Bali (Jakarta).
Au artúb ôs Australia (Novazelándia, Amérika).	I am an Australian (New Zealand, American) citizen.
It hela nei Timor rat arpfl?	How long are you planning to stay in East Timor?
Au hela nei gia rat lelbán limnaitelu.	I am staying here for eight days.
Au hela nei Dili lia.	| will be staying in Dili only.
Am pun planu hana lao foho, rat Suai.	We intend to travel into the country, as far as Suai.
Au ma hur-hur lia.	I am just passing through.
Gin bal It pasaporte.	Show me your passport.
It kaben ni pasaporte herbae?	Where is your wife's passport?
Au ana pasaporte ba nei.	My child doesn't have a passport.
Urá ma uza au pasaporte.	He's travelling on my passport.
Billete au rai vale rat hulai têl.	My ticket is valid for three months.
Au ma Timor dês negósiu.	I have come to East Timor on business.
Au ma Timor men turista.	I have come to East Timor as a tourist.
Au ma Timor dês au hana ma vizita familia.	I have come to East Timor to
It jornalista ka?	Are you a journalist?
Tais id, au balós jornalista.	No, I am not a journalist.
Dio, au jornalista.	Yes, I am a journalist.
Menbae men au ba lao?	Why am I being delayed?
Au kolega ga seri gnan kek her hoh.	I have friends waiting for me outside.
Favor id telefone lao Senór X nor númeru kid-rai.	Please call Mr. X. on this number.
Au glae kek Senór X mais urá ba nei rai.	I am looking for Mr X. but he is not here.
Au sao kid lako tel.	I have lost my friend.
It leb hah urá?	Can you please page him/her?
Aviaun ba lao oras rai.	The flight has been delayed.
Oras heu arpil men lao?	What is the new departure time.
Arpfl men aviaun selu lao Kupan?	When is the next flight to Kupang?
Aviaun hana lao Bali luh ôs bae?	From where does the flight to Bali leave?
Aviaun lao tel sôp ne hei?	Has the plane left yet?
It nei nam id ôd deklara?	Do you have anything to declare?
Ba nei nam id.	Nothing at all.
Au nei sigarru masu kid.	I have some packets of cigarettes.
Au nei nau brusi botir rua.	I have two bottles of spirits.
Au nei mina-morin botir loba kid.	I have a small bottle of perfume.
Au tenke sêl impostu nei rai?	Must I pay customs duty on this?
Au tenke sêl rom?	How much must I pay?
Favor It lae bal pasta kid-rai.	Please open this bag.
Sapid pe nei pasta ra ni lala?	What's in this bag?
Rai Ita ka?	Does this belong to you?
Ra ma au uza rasik.	It is for my personal use.
It al nam gia nei bae?	Where did you get these things?
Au al nei Bali.	I bought them in Bali.
Nam gia prezente lao familia sêrgá.	These things are gifts for friends.
Rai surat id lao Senór X, ôs urá-ni sao nei Austrália.	This is a letter for Mr. X from his relative (friend) in Australia
It nei loi bagajen (naha) seri ka?	Do you have any other luggage?
Taisid, rai lia.	No, this is all I have brought.
4 . Naha au ga herbae?	Where is my luggage?
Naha au ga ba rat hei.	My luggage has not arrived.
Nam id ôs au naha-ga lako tel.	One piece of my luggage is missing.
It tolo naha pil? Au nei rua.	How many pieces of luggage did you have?
Mala tu kid nor pasta loba kid.	I had two pieces: a big suitcase and a small bag.
Favor id glae bal porteiru kid artúb ôd naha.	Please find me a porter.
Rai au.	This is mine.
Laulará mêt au.	Those are also mine.
Pasta nei larán.	The bag is over there.
Mala rai mededa klao.	This suitcase is very heavy.
Kuidadu nor pasta ra.	Be careful with this bag.
Hua bal au naha ga tul lao taksi karreta her ran.	Take my luggage to the taxi (that car over there).
Favor id It ôd bal au naha ga lao hoh.	Please carry my luggage outside for me.
Favor id ma ôs rai.	This way, please.
Favor It tom au.	Please follow me.
Laularán.	It's over there.
Au ba tad au lao dlo bae.	I don't know where to go.
Favor id It Ie hah bal taksi ôd au tio otél.	Please call a taxi to take me to my hotel.
Au hakarak lao Otél X.	I want to go to the X.
Favor id ôd bal au tio diresaun id rai (hati kid-rai).	Hotel . Please drive me to this address (to this place).
Favor id ôd bal au tio banku (tio polisia, tio universidade, tio Kámara Ekleziástika, tio Ambispu ni um).	Please drive me to a bank (to the police station, university Diocesan Office, Bishop's house).
Favor id gnan artúb seri hana tio nor it.	Please wait: there is another passenger going with us.
Favor id lao hua bal naha kid-ran.	Will you please go and get that luggage?
Am put sêl rom nei karreta?	How much is the fare (for all of us)?
It nei metru nei taksi Ita ta?	Do you have a meter in your taxi?
it tenke gio taksi ta ni folin.	We must agree now on the price.
Ra karu klao . Au sêl It rupia ...	That is too much: I will pay you...rupiah.
Au ansi dlo.	I am in a hurry.
Au tenke hur-hur . Hur-hur: Au tarde sôp.	Please hurry: I am (very) late.
Favór It hur-hur . Au sente moras.	Please hurry: I am (he is) feeling sick.
Balikan hur-hur (ansi).	There's no need to hurry.
Salolo kid tio otél ta, ôd am pasiar ana ha volta Dili.	Please take us on a short tour of Dili on the way to the hotel.
It leb tou bal am hati kid ran gala sapid?	Can you tell us what that place is?
It kondutór kode.	You are a good driver.
It leb ma ada ôd am pasiar tio hati selu?	Will you come to the hotel tomorrow to take us somewhere?
Tuk pil men au leb ma?	What time will I come?
Favór id It ma tuk limnaipata busloi.	Please come at nine o'clock in the morning.
Artúb ubu-pil lao Ermera nor It?	How many people are going with you to Ermera?
Au lia.	Only me.
Artúb ubu-tel loi: mau- mane rua nor bui-hine kid.	Three other people: two men and a woman.
Au gala ...	My name is ....
It nei tel sôp hati?	Do you have a reservation?
Au hati ba nei.	I have (don't have) a reservation.
Au hameno kek kuartu kid rat lelbán têl semana kid ôs Austrália.	I booked a room for three days (one week) from Australia.
It sim hameno ôs au?	Did you receive my booking?
Konfirmasaun pe rai.	Here is the confirmation.
Departamentu Turizmu ni pe haruka am ma.	he Tourist Office sent us here.
Pasaporte au pe rai.	Here is my passport.
Vistu au rai rat hulai têl.	I have a three months visa.
Rai heikana primeira vés au ma nei Timor Lelsae.	This is my first visit to East Timor.
Au ma Timor hat rua sôp (hat têl sôp).	This is my second (third) visit to East Timor.
Favor id né sul pasaporte au-ta ma.	Please give my passport back to me.
Favor It prenxe bal surat rai.	Please fill out this form.
Napai data sapa? Lelbán sapa?	What is the date today, please?
Porfavór asina nei rai.	Sign here, please.
Au ba tad Ie Bahasa.	I can't read Indonesian.
Porfavór rai tou sapid?	What does this say, please?
Otél rai gala sapid?	What is the name of this hotel?
Otél rai ni diresaun gala sapid?	What is the address of this hotel?
Otél rai ni númeru telefone pil?	What is the phone number of this hotel?
Au hakarak hela nei rai hoda pat.	I would like to stay four nights here.
Arpil men It sai ôs rai?	When will you be leaving?
Parese sábadu au sai ôs rai.	I will leave (perhaps) on Saturday.
Au ba tad hei.	I don't know yet.
Am gnan loi artúb selu hana ma nei lelbán-sesta.	We are expecting another person tomorrow (on Friday).
Au boi hela nei rai.	I don't want to stay here.
Obrigadu.	Thank you anyway.
Deskulpa, otél rai benu (hati ba nei).	Sorry, the hotel is full.
Nei otél seri nei vila rai?	Is there another hotel in the town?
It leb rekomenda (glae) otél kode ma au?	Can you recommend (find me) a good hotel?
Sêb gia nei kuartu seri para aluga?	Are there any boarding houses near here?
It leb glae kek familia seri am au hela?	Could you arrange for me to stay with a family?
It tenke tou sai polisia.	You must report to the police.
Am tenke ôd It pasaporte ta lao	We have to take your passport
polisia.	to the police station.
Arpil men au leb sim sul pasaporte?	When will I get my passport back?
Au leb sêl nor kartaun Visa?	Is it possible to pay with my credit card (Visa card)?
Os-rahu ba nei.	I don't have any cash.
Au tenke lao banku.	I must go to the bank.
Au presiza troka os australianu (Novazelándia).	I need to change some Australian (New Zealand) money.
Leb au sêl It nor os australianu?	Can I pay you in Australian bills?
Favor id né resibu ma au.	Please give me a receipt.
Favor id haruka artúb id ma ôd bal au pasta.	Please send someone to take my bags.
Favor id It glur bal ada busloi tuk limnainide.	Please wake me at 6am tomorrow.
It leb telefone?	Can you ring?
Favor id It pei bal taksi ma au.	Please call me a taxi.
Au tenke lao Aileu busloi rai.	I must go to Aileu this morning.
Nei rai am leb aluga karreta?	Is it possible to hire a car?
Au kartaun-kondusaun internasionál pe rai.	Here is my international licence.
Napai au sai tel ta artúb seri ma glae au?	Did anyone come to see me while I was out?
Napai au sai tel ta artúb seri telefone ma?	Was there a phone-call for me while I was out?
It gosta kuartu mensapa ni, Senór (Senora)?	What kind of room do you want, Sir?
Au hakarak kuartu nor kama kid, nei riu-hati nor sentina.	(Madam?, Miss?) I want a single room with bath and toilet.
Nei kuartu seri nor torneira riu ni?	Is there a room with a shower?
Au hakarak kuartu nor kama rua.	We want a double room.
Am hakarak kuartu kid nor kama loba rua.	We want a room with two single beds.
Am hakarak kuartu kid nor kama kid lao artúb ubu rua.	We want a room with a double bed.
Kuartu au ta númeru pil?	What is the number of my room?
Kuartu au ta nei andár pil?	What floor is my room on?
Au hakarak kuartu nei andár lau.	I would like a room upstairs.
Au ba gosta kuartu nei andár sua.	I don't want a room on the ground floor.
Am hakarak kuartu nor ar kondisionadu (ventuina).	We want a room with air- conditioning (a fan).
Favór id glae ma au kuartu kid kalma.	Please find me a quiet room.
Leb It atama loi kama kid nei kuartu?	Can you put another bed in the room?
Nei kuartu rai er brus ma?	Is there hot running water in the room?
Nei gargón paraôd gnon er?	Is there is a kettle in the room so that we can boil water?
Kuartu rai nei fixa para It liga elétrika ne tais?	Is there a power point in the room?
Fixa elétrika rai leb uza nei rai?	Will this kind of electric plug fit the socket?
Deskulpa, kuartu kid mendá It ta ba nei.	Unfortunately we don't have a room like that.
Kuartu kid pe au glae ta pil?	What is the price of the room I want?
Kode, au hakarak hua pe rai.	Good, I will take this room.
Kuartu rai nei televizaun?	Does the room have a television set?
Nei rai televizaun et kanál pil?	How many channels can we pick up here?
Leb et kanál Portugál ne tais?	Can I pick up the Portuguese satellite channel also?
Leb au empresta mákina-video ôd pei video-kasete?	May I borrow a video-recorder (to play videos?
It nei kuartu kid baratu?	Do you have a cheaper room?
Mau-loba kid hei ôd bal It lao kuartu.	A boy will take you to your room.
Balikan tamau lao It naha ga: am hei ôd kek lao It kuartu.	Don t worry about your luggage: we will have it brought to your room.
Otél rai nei restaurante ne ba nei?	Is there a restaurant in the hotel?
Ni folin ta konta mêt nor nam-á?	Does this price include all meals?
Taisid . Konta lia matabixu.	No, it includes breakfast only.
Matabixu serve nei bae?	Where in breakfast served?
Matabixu serve her sala-jantár nei ran.	Breakfast is served in that dining room through there.
Tuk pil men im serve matabixu?	What time is breakfast served?
Am serve matabixu nei tuk limnairua rat tuk limnaipata nor seri.	Breakfast is served from seven o'clock till half past nine.
Leb It ôd bal matabixu tio au kuartu?	Can I have breakfast brought to my room?
Leb, mais It tenke prenxe surat rai.	Yes, but you must fill out this form.
Favor id haruka xa (kafé) tio au kuartu.	Please send some tea (coffee) to my room.
Favor id haruka nam-á loba lao kuartu númeru ...	Please send a snack to room number ....
Nei otél rai leb has nam-eta?	Does the hotel wash clothes?
Au lop kek nam-eta foer hana has nei bae?	Where do I leave my clothes to be washed?
Arpil has nam-eta né sul ma au?	When will my washing be brought back to me?
It nei pivete-bomba? (ai-moruk susuk ni?)	Do you have some insect repellent?
It nei moskiteiru?	Do you have a mosquito net?
It nei pivete elétriku?	Do you have an (electric) mosquito coil?
Au karak telefone lao Australia (Novazelándia).	I would like to make a call to Australia (New Zealand).
Au hakarak pei livru telefone ni.	I d like to see the telephone directory.
It leb glae bal númeru rai?	Would you please find me this number?
Leb It hah bal númeru rai ma au?	Will you please dial this number for me?
Leb It haruka faks ôs otél rai?	Can I send a fax from this hotel?
Favor id It tradús bal rai ma au.	Would you please translate this for me.
Au ba komprende.	I don't understand.
Favor It tou bal telefonista pun ...	Will you please tell the operator that ...?
Favor tou bal lao urá pun ...	Please tell him/her that ....
Favor id ôd bal surat-nora hakerek nor envelope.	Please bring me some writing, paper and envelopes.
Au hakarak sak xefe otél rai ni.	I wish to see the manager of the hotel.
Nei Austrália ro tou pun otél konta mêt nor nam-á.	I was told in Australia that meals would be included.
Au tug kuartu kid nor riu-hati nor sentina.	I asked for a room with a bath and toilet.
Kuartu rai riu-hati ba nei.	This room has no bathroom.
Ventuina (ar kondisionadu) ta ba mori kid.	The fan (air-conditioner) is not working.
Torneira er ni ba nei.	There is no water in the tap.
Er-sentina ba sai.	The toilet doesn't flush.
Pun favor leb It hadia hur-hur?	Please have it repaired immediately.
Surat-nora sentina ni ba nei.	There is no toilet paper in the room.
Lensól-kama ba troka.	The bed linen has not yet been changed.
Xave salmata ni klao tel sôp.	The lock on my door is broken.
Nei au kuartu ap ba Iio kid.	The light does not work in my room.
Favór id troka lámpada.	Please change the globe.
Au ba tad lae rádiu (televizaun).	I don't know how to work the radio (the television).
Au ba gosta kuartu rai.	I don't like my room.
Favór id glae sul selu ma au.	Please find me another one ..
Ba nam id se karu klao.	It doesn't matter if it's more expensive.
Kuartu selu ran folin pil?	How much will the other room cost?
Nei artúb seri pun barullu.	There are some people making a lot of noise.
Au boe bakode.	I can't sleep.
Artúb id her laularán pe pun susar au.	There is a person there bothering me.
Konta rai sal katkene.	There is a mistake in this bill.
Au ba hua nam id ôs jeleira.	I did not take anything from the fridge.
Au ba tug nam ra.	I did not ask for this thing.
Au pun lako tel xave kuartu ni.	I have lost the key to my room.
Au lop kek xave nei rai, ne au ôd?	Do I leave my key here, or can I take it with me?
Favór id né xave kuartu númeru sagúl hatrua-resi-pat ni.	Please give me the key to room 24.
Au hei lui kek nam folin ni nei im kaixaforte.	I would like to leave something in your safe.
Favór It né sul au relójiu (korrente, dokumentu) ôs kaixaforte.	Please bring me my watch (my jewelry, my documents) from the safe.
Favór It prepara nota sêl ni.	Please prepare my bill.
Au sai ada busloi.	I am leaving tomorrow morning.
Tuk pil men am leb sai ôs kuartu?	What time must we leave the room in the morning?
Favór id It lui dês rai ma au konta.	Please add this to my bill.
Serve nei rai kode dlo.	The service was very good here.
Au hakarak rekomenda otél rai lao au kolega sêrgá.	I will be happy to recommend this hotel to my friends.
Banku kid sebi herbae?	Where is the nearest bank?
Leb It tabár bal salolo ma au ôd lao banku?	Can you show me the way to a bank?
Tuk pil men banku lae nor ta?	What time does the bank open and close?
Lelbán sapa lia men banku lae?	Which days is the bank open?
Troka os hati nei.	Is there a money exchange here?
Nei bae men au leb troka os?	Where can I change this money?
Leb au troka os nei otél rai?	Can I change money at this hotel?
Dolar nor rupia napai ekivalénsia pil?	What is the current exchange rate for Australian dollars?
Folin napai rai badún kode.	The present exchange rate isn't very good.
Au hakarak troka xeke-viajen gia lao rupia.	I would like to change these traveller's cheques into rupiah.
Au hakarak depózitu au osa nei númeru-banku ....	I want to deposit money into the account of ...
Favor né xeke banku en-lao os folin ....	Please prepare me a bank cheque for the amount ...
Favor pun xeke lao dolar amerikanu.	Please make out the cheque in American dollars.
Leb it aluga karreta nei Ainaru?	Is it possible to rent a car in Ainaro?
Karreta rai leb tul artúb ubu-pil?	How many people can fit in that car?
Nei karreta tu lao artúb ubu- limnaitelu ka rês?	Is there a bigger vehicle available to seat eight or more people?
Aluga lelbán id pil?	How much is the car rental per day?
Rai konta mêt seguru? (/.	Is insurance included?
asuransi?) It nei karreta automátiku ne manuál lia?	Do you have an automatic car or only a manual?
Pun favór It leb enxe gazolina.	Please fill the tank with petrol.
Au sêl gazolina ka folin ta put lia?	Do I pay for the petrol, or is included in the price?
Favór id pei bal óleu nor er.	Please check the oil and water.
Nei vila bae pe It leb enxe gazolina?	In which towns can we get petrol?
Sel lao distánsia met nei?	Is there a mileage charge also?
Leb gin It karta-kondusaun internasionál?	Please show me your international driver's licence.
Leb au sêl nor kartaun-kréditu?	Can I pay with my credit card?
It tenke sêl nor depózitu.	You must pay a deposit.
Favór haruka kondutór ma gase ingles (portugés, tetun, mambae indonézia).	Please send me a driver speaks English (Portuguese, Tetum, Mambai, Indonesian).
Am hakarak kondutór id lala-kode nor gosta gase.	We would like a friendly driver who likes to chat.
Nei Timor it ôd karreta nor it lima toi-heko.	In Timor we drive on the left.
Ainaru ba nei ap-ana sinaleiru.	There are traffic lights in Ainaro.
Im prepara nam-á meiudia ka nam-á hoda?	Do you serve lunch (dinner)?
Am leb para karreta nei bae?	Where can we park our car?
Tuk pil men im lae nor tá?	What time do you open and close?
Prepara meza kid la am têl.	We want a table for three.
Au hakarak meza kid lao ada hoda.	I'd like to book a table for tomorrow evening.
It hei medei put.	We will sit together.
Leb am medei sêb janela?	May we sit near the window?
Nei janela bae pe am leb pei sai?	Do you have a table with a nice view?
Am gosta medei nei hoh.	We prefer to sit outside.
Favor od kadeira selu ma.	please bring another chair.
Am hakarak mua nor ên loba lia.	We want something light only.
Am hakarak lia kafé (xa, serveja).	We only want coffee (tea, beer).
Favór id: leb ...?	Excuse me: can you ...?
Am ansi dlo.	We are in a hurry.
Nei rai brusi klao.	It is very hot.
Leb It pun bias? (ar kondisionadu?)	Can you put on the fan (air-conditioning)?
Favór It hatún (pun mat, muda) múzika ta.	Please turn down (turn off, change) the music.
Leb It toka múzika Timor?	Can you play some Timorese music?
Leb It serve am hati'd?	Can you serve us at once?
Am ma sul nei oras id ni lala.	We will come back in one hour.
Favór id ôd lista nam-á ni ma.	Please bring the menu.
Nam-á rai kode?	Is this dish good?
Nam-á rai brusi (bia)?	Is this dish hot (sweet)?
Favór id ôd bal salada ma am.	Please bring us a salad.
Favór id ôd bal sia nor pimenta (mina) ma.	Please bring salt and pepper (oil).
It sio nau-uvas portugés?	Do you have Portuguese wines?
It serve serveja bae?	What beer do you serve?
It leb né ...	Do you have ...?
Bonproveitu!	Bon appétit!
Ikan rai kode.	This fish is good.
Gala sapid?	What is it called?
It pun mêt kaldeirada?	Do you make fish stew?
Au dieta, au balikan mua.	I am on a diet . I can't eat.
Pun favór id ôd paun (er, er-ákua).	Please bring bread (water, mineral water).
Au ba gosta ên nor jelu.	I do not want ice in my drink.
Er rai gnon tel sôp?	Has this water been boiled?
Au ba gosta er torneira: favór ôd ákua ma.	I don't want water from the tap; please bring mineral water.
Ra ba mo kid.	This is not fresh.
Nam-á rai bakode.	This food is bad.
Rai nei hula demais.	This has too much fat.
Nei sus-era paraôd sur put nor xa (kafé) rai?	Do you have milk for the tea (coffee)?
Baléb pôs masmidar lao xa (kafé).	Don't put sugar in my tea (coffee).
Au gosta xa (kafé) nor er nakali dlo.	I'd like my tea (coffee) boiling hot, not lukewarm.
Favór id ôd nam midar seri ma mua nor kafé.	Please bring something sweet to eat with the coffee.
Napai nei sobremeza sapa?	What dessert do you have today?
Favór ôd sigarru ma.	Please bring me some cigarettes.
Au leb has lima herbae?	Can I wash my hands?
Kazadebanu herbae?	Where is the toilet?
Surat-nora sentina ni ba nei.	There is no toilet paper.
Ma lolai tom lia salolo rai.	(Come/go) this way.
Au ba et.	I can't find it.
Leb tabár ma au?	Please show me the way.
Favór ôd konta ma.	Please bring the bill.
Konta rai sal katkene.	There is a mistake in the bill.
It ba ôd nam gia.	You did not bring us this.
Deskulpa, au pun sal.	Sorry, I made a mistake.
It nei troka?	Do you have change?
Nam-á napai kode.	The meal was very good.
Favór id né bal palitu ma.	May I have some toothpicks?
Rai nam loba kid au né lao It.	This is a tip for you.
Favór id hur-hur: am nei tempu katkene.	Please hurry: we have little time.
Hati rai serve artúb kode dlo.	The service here is very good.
Napai am hana lao Same.	Today we want to go to Same.
Aluga karreta lao Ermera sêl pil?	How much do you charge for the trip to Ermera?
Lao-ma sêl pil?	How much will you charge take us there and back?
Am hakarak fila sul ma Ainaru.	We want to return to Ainaro on the same day.
Ôs rai lao rat laularán oras pil?	How many hours is it from here to there?
Dambát rai kode?	Is the road good?
Am hakarak deskansa nei hati kid ôd mua meiudia (ôd ên kafé).	\Ne would like to stop somewhere for lunch (for coffee).
Am hakarak vizita igreja nei Aileu.	We would like to visit the church in Aileu.
Au hakarak lao kumprimenta amupadre pároku.	I would like to pay my respects to the parish priest.
Favor id fila lao lima dlo.	Please turn right.
Favor id fila lao lima toi-heko.	Please turn left.
Lao dlo lia.	Go straight ahead.
Baléb plar makás.	Don't drive so fast.
Plar hel-hel lia.	Slow down.
Prega It sintu karreta ni ta pun tama.	Please fasten your seat belt.
Favor pun mat tel: au ba gosta plig múzika kid.	Please turn the radio off . I don't want to listen to music.
Hatún katkene volume ta: bohaha demais.	Please turn the radio down: it is very loud.
Dambát rai ta.	The road is closed.
Nei hati tropa ni: it balikan tio.	There is an army road block: we cannot continue our journey.
It tenke fila tio hoho.	We must turn back.
Dambát kdot dês er slog (er du).	The road is cut by flood waters.
Ponte ba kode . Rai perigozu para it tio.	This bridge is too dangerous to cross.
Karreta rua xoke lor nei dambát- kurva ran.	There was a collision (of two cars) at that bend in the road.
Au tenke glae hati enxe loi gazolina.	I must stop to buy more petrol.
Au tenke pôs óleu (er) lao karreta.	I must put oil (water) in the car.
Karreta roda gua.	We have a flat tyre.
Au tenke troka.	I must change the wheel.
Favor leb sai ôs karreta.	Please get out of the car.
Favor id gnan au nei rai: Au sei ma hur-hur.	Please wait here for me: I will come back soon
It para bal nei hati seri . Au sente moras.	’ lease stop somewhere: I am feeling sick.
Favór para bal . Au hana lao sintina.	Please stop: I must go to the toilet.
Se It sente moras, pei lao ahe: baléb pei lao hoho (lao sua).	If you are feeling sick, look ahead: don't look back (don't look down).
Karreta klao tel.	The car has broken down.
Au tenke ôd lao hadia.	I must have it repaired.
It tenke boe nei knua rai.	We will have to spend the night in this village.
Am beli (mro) klao.	We are hungry (thirsty) now.
Leb it para hur-hur para it ôd al nam?	Can we stop soon to buy something?
Au sehél it mua (it ên) put.	I would be happy for you to eat (drink) with me.
Baléb suat.	Don't be shy.
Am ôd nam-á nor er.	We brought some food and drink.
It gosta?	Would you like some?
Hati rai gala sapa?	What is this place called?
Nei amupadre seri hela nei rai?	Is there a priest living here?
Nei madre hela nei vila rai?	Are there nuns in this town?
Nei rai doutór nei?	Is there a doctor here?
Nei enfermeiru (enfermeira) nei klfniku?	Is there a nurse or a clinic?
Favór It gnan: Am hei vizita bal artúb rai.	Please wait while we visit person.
Favór It ma al am nei tuk têl.	Please come back for us at three o'clock.
It pal karreta kapás dlo.	You are a very good driver.
Rai os kole ni lao It.	Here is a tip.
(Rai ôd al sigarru.)	Please accept this gift.
It nei kartaun nor gala, diresaun no númeru-telefone?	Do you have a card with name, address and phone number?
Au hakarak hameno It tio au kolega sêrgá.	I will be happy to recommend you to other people.
Bondia (botarde, bonoite).	Hello.
gala bae?	What is your name?
Au vizitante ôs rae-Novazelándia.	I am a visitor from New Zealand.
Au doutór (enfermeira, mestre, padre, madre) ôs Austrália.	I am a doctor (nurse, teacher, priest, nun) from Australia.
Au gala Senór...Senora ...	My name is ....
Au gala Padre...Madre ...	My name is Father..., Sister ...
Au lala-kontente ma sak It.	I am very happy to meet you.
Au ma ôs Estadus Unidus, rae- Filipinas, rae-lnglaterra, rae- Irlanda).	I am (we are) from USA (Philippines, England, Ireland).
Au hela nei Sydney (Londres).	I live in Sydney (London).
Au konese Timór-ana niri nei Melbourne.	I know many Timorese people in Melbourne.
Au kolega kode kid ôs Timor hela nei Darwin.	I have a good Timorese friend in Darwin.
It kaben-nain?	Are you married?
Senora rai It kaben?	Is this lady your wife?
It nei ana pil?	How many children do you have?
Au ana nei lim: mau-mane rua nor bui-hine tel.	I have five children: two boys and three girls.
Rai au ana-mane (rai-hine).	This is my son (my daughter).
Urá gala bae?	What is his name?
Rom gala bae?	What are their names?
Urá-ni gala ...	His (her) name is ...
Urá tona pil?	How old is he?
Urá ton sagúl.	He is ten years old.
Au ama mate tel sôp.	My father is dead.
It serbi's sapa?	What is your profession?
Au mestre.	I am a teacher.
It gosta serbis Ita ta?	Do you like your job?
It ôs Ermera?	Do you come from Ermera?
It mori nei bae?	Where were you born?
It nei ká nor kau pil?	(to a child) have you?
Rom mori mêt.	Are they all alive?
Urá mate arpi' l?	When did he die?
Koitadu.	I am sorry to hear that.
Leb au pei It ama ni rate?	May I visit your father's grave?
smaga.	| would like to pray for his soul.
Am hakarak lui ai-funan lao urá-ni rate.	We would like to place some flowers on his/her grave.
Rai au fami'lia ni letratu.	Here is a photo of my family.
It nei familia kode?	You have a beautiful family.
It ana gar mes edukadu mêt.	Your children are well brought-up.
Kmanek tu kid ma au ôd vizita It uma.	I am very honoured to visit your home.
Pun favor sim bal nam rai.	Please accept this small gift.
It mêt pun nam kode ma au.	You have all been very kind to me.
Au sei hanoin nam bae pe It ne kode ma au.	I will remember your kindness to me.
Maromak pe hei sêl It hahalok kode kid la am.	May God reward you for your kindness to us.
Au hei reza la im arpi' l pun orasaun.	I will remember you (and your family) in my prayers.
Maromak hei né bensa la It nor It fami'lia.	May God bless you and your family.
Au hei ba mlig ma vizita hati rai.	I will not forget my visit here.
Baléb mlig au: it hei komunika lao lor.	Don't forget me: we must keep in touch.
Diresaun au nei Austrália pe rai.	Here is my address in Australia.
Númeru telefone (númeru faks ni, korreiu eletróniku) pe rai.	This is my phone number (my fax number, my email address).
Se It hakerek gala nor diresaun, au hei haruka kartaun postál ma ôs laulagá.	If you write your name and address for me, I will send you a postcard from my country.
Se It tio Australia, It leb hela nor am.	If you come to Australia, you can stay with us.
It leb hakerek ma au nor lia mambae: au nei kolega para tradús.	You can write to me in Tetum: I have a friend who can translate.
o o,	N.B.
Hei an-loba sêrgia!	Hello, children!
O gala bae?	What is your name?
It gala bae?	How old are you?
tona pil?	How many brothers do you have?
O nei ka nor kau pil?	How many sisters have you?
Rai au kau-hine loba pe rai.	That is my younger brother.
Rua rai au ku ubu-ru.	These are my two older sisters.
Au kau-hine loba ta her kek um.	My younger sister is at home.
Au ana-mane (ana-hine, kau, topó) tona men o.	I have a son (a daughter, a brother, a sister) about your age.
O hela herbae?	Where do you live?
O eskola ka?	Do you go to school?
O gosta eskola ne tais?	Do you like school?
Nei eskola o gosta dlo sapid?	What do you like doing best at school?
O mêt aprende ingles her eskola?	Are you learning English at school?
O tad Ie?	Do you know how to read?
O gosta Ie?	Do you like reading?
Kuandu o tu, o hakarak sai sapid.	What do you want to do when you grow up?
O hakarak estuda nei universidade?	Do you want to study at university when you finish school?
O gosta rebusadu?	Would you like a sweet?
O gosta xokolate?	Would you like a chocolate?
O gosta imajen Maromak?	Would you like a holy picture?
O gosta kartaun postál?	Would you like a postcard?
Rai hati au hela nei Austrália (Estadus Unidus, rae-Kanadá).	This is the place where I live in Australia (USA, Canada).
Rai animál (man) ôs Austrália.	This is an Australian animal (bird).
Timor nei animál mendai?	Do you have animals like this in Timor?
O an-mane kode.	You are a good boy.
O an-hine kode.	You are a good girl.
Au hei tug lao Maromak ôd tulun o mori.	I will ask God to bless you and help you throughout your life.
O sei sai kode ôd ajuda o fami'lia.	You must be good and help your parents.
O ama parese hanoin niri: o tenke pasiente.	Your father is very worried: you must be patient.
O ina lala-susar: o tenke ajuda urá.	Your mother is very sad: you must help her.
O ina nor ama sorte dês rom et an-mane (an-hine) kode men o.	Your parents are very lucky because you are such a good boy (girl).
Baléb pun mendá.	Don't do that.
Tou la rom pun para tel.	Tell them to stop doing that.
Balikan bohaha gau!	Stop shouting!
Artúb id, hat id!	One at a time, please!
Né obrigadu lao o ina nor o ama.	Tell your father (your mother) thank you very much.
Favor né nam rai lao o ama (lao o ina).	Please give this to your father (your mother).
Artúb nei knua rai gase lia sapa?	What language do the people speak in this village?
It tad lia Turiskai?	Can you understand the language of Turiscai?
Dialetu rom-ni ga men ita.	Their dialect is similar to ours.
Am tad katkene lia.	We can understand only a little.
Am gase nor artúb sergia tero- tetun.	We communicate with those people in Tetum.
Au hakarak aprende gase It tero.	I would like to learn your language.
It leb glae artúb id gase tero ra?	Can you find me a person who speaks that language?
Nei It tero er hah pun men sapa?	How do you say 'water' in your language?
Favór id hakerek ter-hua rai ma au?	Would you write that word down for me?
Au hakarak pun lista en-lao im tero.	I want to make a list of words in your language.
Au tad lia tero-tetun . Tou bal ter-hua lia mambae ma au.	I will say the Tetum word: please tell me the Mambai word.
Rae-Timór ni kultura riku dêsni nei tero niri.	East Timor has a rich culture because it has many languages.
It balikan suat tero rai, dês ma ôs bizavón sêrgá.	You should not be ashamed of your language: it's a gift from your ancestors.
It tenke dôm It tero, nôr lao It ana gar.	You should value your language and pass it on to your children.
Au hakarak hakerek kontu (hananu) ra nei It tero ta.	I would like to write down that story (song) in your language.
Leb It pun tradusaun tetun lao istori rai?	Can you make a Tetum translation of the story?
Favór tou ma au en-lao nam (kostume) rai.	Please tell me about this thing (this custom).
It leb pinta nam rai?	Can you draw a picture of this thing?
It leb tabár ai ra?	Can you show me that plant?
(ai-hua ra?	(that fruit?
modo ra?)	that vegetable?)
Leb It tabár bal animál ra ma au?	Can you show me that animal?
It tad, bizavón sêrgá ma ôs rae bae?	Do you know what land your ancestors came from?
Au sehél et ro ôd dansa rai.	I would like to see people perform that dance.
It leb hananu kantiga rai ma au?	Can you sing that song for me?
Leb au grava hananu (istória) rai nor au gravadór?	Do you mind if I record this song (this story) with my tape-recorder?
Leb au hasai retratu?	May I take a photo of this?
Leb it et um-luli?	Is it possible to visit the village totem-house?
Leb It tabár nam luli en-lao bizavón?	Can you show me the places (the things) that are sacred to your ancestors?
Favór tou sai au se au pun sal, dês au artúb malae.	Please tell me if I do something wrong, because I am a foreigner.
Au hakarak respeitu im lisan.	I want to respect your customs.
Au sente moras.	I am feeling sick.
Hur-hur hah doutór ma!	Get a doctor, quickly!
Leb It hah doutór ma?	Can you get me a doctor?
Otél (knua) nei doutór?	Is there a doctor in the hotel (village)?
Favór telefone doutór hur-hur.	Please telephone for a doctor immediately.
Favór kontaktu nor au sao sêr her Dili (au familia her Novazelándia).	Please contact my friends in Dili (my relatives in New Zealand).
Númeru telefone pe rai.	Here is the phone number.
It leb rekomenda doutór kode kid?	Can you recommend a doctor?
Nei doutór seri leb gase inglés?	Is there a doctor who speaks English?
Nei doutór?	Is there a lady doctor?
Hati doutór pratika herbae?	Where is the doctor's surgery?
Tuk pil men doutór ma?	What time can the doctor come?
Favor ôd bal au tio doutór (kliniku, ospitál).	Please take me to the doctor's surgery (to the clinic, hospital).
Au moras mededa hana lao mesa.	I am too ill to go alone.
Leb au konsulta doutór agora?	May I see the doctor now?
Arpil men au leb konsulta?	When can I see him?
Au moras mededa.	I am very sick.
Au hakarak hameno nor doutór.	I'd like to make an appointment to see the doctor.
Tuk tel au ba leb.	Three o'clock isn't possible for me.
Au leb sak It nei tuk lim?	Can I see you at five o'clock?
Senór (Senora) leb ma sul ada tuk limnaipata.	Please come back tomorrow at nine o'clock.
Favor id leb gnan nei rai.	Please wait here.
Doutór ma agora.	The doctor will come soon.
Au sente badún kode.	I am not feeling well.
Au moras dlo.	I am in great pain.
Favor It né au ai-moruk pun lako moras rai hur-hur.	Please give me a strong pain-killer quickly.
It moras sap pe?	What sickness do you have?
Au kui-moras (Au moras-diabete).	I am a diabetic.
Au sofre moras-busa (enxakeka, malária).	I am suffering from asthma (migraine, malaria).
Au moras hua.	I have a bad heart (heart condition).
Au moras kankru.	I have cancer.
Au positivu aga-i-vé . (Au sofre moras-SIDA).	I am HIV-positive (I have AIDS).
Favor It medei tel.	Please sit down.
Moras nei bae?	Where does it hurt?
Au moras nei rai.	I have a pain here.
Au ulu-hatu sae moras.	My head aches.
Au moras estómagu.	My stomache aches.
Au eta-lolo mêt moras.	I am aching all over my body.
Au ahe-brua.	I feel dizzy.
Au sente lala-sae.	I feel nauseous.
Au ahe-brua meta; au mou hat pil.	I have fainted several times.
Au eta-sigig.	I am shivering.
Au rati niri.	I am sweating a lot.
Au sente eta-brus.	I seem to have a fever.
Favór It pei rai.	Please look at this.
Au hakarak konsulta It.	I want to examine you.
Moras arpila?	When did the pain begin?
Moras ra ataka arpila?	How long have you had this illness?
It moras nanis ka?	Have you had this pain before?
It ên tel sôp ai-moruk id mola It ma Timór?	Did you take medicine for this illness before coming to Timor?
It ên ai-moruk sapa lao kondisaun rai?	What medication are you taking for this condition?
Ai-moruk rai It ên ne sa?	Do you take this medicine by mouth or by injection?
It ên tel kininu pil sôp?	How many pills have you been taking?
Hat pil sôp It et moras rai?	How often do you get this pain?
Bakbako.	All the time.
Hati'd-hatid.	Every so often.
Nei hoda lia.	Only at night-time.
It sente moras nei rai?	Do you feel any pain here?
Tou sai au atmen moras arpil au dês.	Tell me if it hurts when I touch you.
Dio, ra moras.	Yes, it hurts.
Tais, badún moras.	No, it doesn't hurt much.
Taisi'd, ba moras id.	No, it doesn't hurt at all.
Au sente isi-matek nei rai.	I feel numb (here).
Rai dês ni dezastre ne artúb pe dae?	Was this an accident or somebody hurt you?
Lui termómetru nei It lama sua minutu kid ka paglau.	Put this thermometer under your tongue for a minute or so.
Favór asai tel It har.	Please take off your shirt.
Favór id asai tel urá ni nam-eta hena.	Please undress.
Favór It asai tel rat trua.	Plese undress down to the waist.
Lae gugu.	Open your mouth.
Dad snuga makás.	Breathe deeply.
Favór It tahu.	Cough please.
Tolo lima pun naru.	Lift your arm as high as you can.
Favór asai tel It kalsa no kuekas (kalsina).	’ lease remove your trousers and underpants (panties).
Favór It boe nei meza.	’ lease lie on the table.
Bobar bal It haru-lima ta.	Please roll up your sleeves.
Au tenke sa It.	must give you an injection.
Favór pun dlo bal It oe ta.	Please straighten your leg.
Sa rai moras katkene.	The injection may hurt a little bit.
Tou la It ana ta balikan dlai.	Tell your child to keep very still.
Tou la urá balikan tamau.	Tell him not to be afraid.
Au hana pal It pulsu.	I am going to feel your pulse.
Au hana pei iru-mata nor estetoskópiu.	I'm going to examine your chest with the stethoscope.
Au tenke hua kui ôd pun ezemplu ...	I must take a specimen of your urine.
Au hana kok tensaun lar ni.	I'm going to take your blood pressure.
It sul tabák?	Have you been smoking?
It baléb sul tabak sôp.	You must give up smoking.
It sehél ên nau brusi?	Do you drink a lot of alcohol?
It baléb en nau brusi loi.	You must stop drinking alcohol.
Rai akuza.	This is infected.
Rai lar en venenu.	(the blood is poisoned).
Rai ba grave kid.	This is not serious.
It lima pou.	You have fractured your arm.
It oe-snaga naksala.	You have sprained your ankle.
It dad tel urat ta.	You have pulled a muscle.
Balós, It oe ba tabas id (ba pou kid).	No, your leg is not broken.
Tububu rai hei du hur-hur.	The swelling will go down soon.
Eta-sae hei kode nei lelbán pil ma rai.	The fever will stop in a few days' time.
It ba nei nam id.	There's nothing wrong with you.
Kondisaun Ita ta ba grave kid.	Your condition is not serious.
Au lala nervus kek lia.	I am in a nervous state.
Au sente lala-mededa.	I am feeling very depressed.
Hoda au boe ba kode . Au presiza ai-moruk boe ni.	I can't sleep at nights: I need some sleeping pills.
Leb It né reseita ai-moruk boe ni ma?	Can you prescribe a tranquillizer?
It tenke deskansa rini.	You must get plenty of rest.
Urá tenke deskansa rat semana rua.	You must drink lots of liquids.
It tenke ên er niri.	Don't worry so much.
Baléb hanoin niri.	Try to be calm.
Kode paglau It hela nor artúb selu . Baléb mesa.	You need to be with other people: Do not stay alone.
It tenke glae salolo lolai lelbán- lelbán.	You should go for a long walk every day.
Au hei né reseita ai-moruk kode.	I will prescribe a good medicine.
Au hei né ai-moruk boe ni.	I will give you a sedative.
Orsid It sente kode rês.	You will feel better soon.
It tenke ên ai-moruk rai hat tel nei lelbán id.	You must take these pills three times a day.
It ên ai-moruk rai hat pat nei lelbán id.	Take this medicine every four hours.
Pôs ai-moruk rai lao It mata hatrua nei lelbán id.	Put two drops into your left eye twice a day.
It ên ai-moruk niri demais.	You are taking too many pills.
Baléb ên ai-moruk niri mendá.	You must take less pills.
Arpi' l dad snuga bakode, lui kápsula rai nei gugu, depois dad snuga.	You must inhale this capsule whenever you can't breathe properly.
Kos mina-manas rai lao It ana ta ni hoho.	Rub this ointment on to your baby's back.
It nei paraôd al ai-moruk?	Have you got money to buy this medicine?
Ai-moruk rai au né lia; ba presiza sêl.	I will give you the medicine for free.
Au hei has nor pôs ligadura nei It oe.	I will wash and bandage your foot.
It tenke troka ligadura lelbán- lelbán.	You must change the dressing (bandage) every day.
Urá-ni kondisaun grave dlo.	His condition is very serious.
Urá tenke lao hur-hur ospitál.	He must go to hospital at once.
It tenke opera hur-hur.	We must operate as soon as possible.
Au tenke asai raiu-xis.	I must take an X-ray.
Au rekomenda paraôd It lao konsulta nei doutór espesialista nei Dili.	I want you to see a specialist in Dili.
It tenke pun tratamentu ôd pei moras bae dlo.	We must do some tests to see what the problem is.
Rai parese karu.	It may be expensive.
It nei seguru moras ni?	Do you have medical insurance?
Kode paglau It lao ospitál nei Darwin.	It's best if we send you to hospital in Darwin.
Au rekomensa para It lao pun tratamentu nei laularán hei semana ahe ma.	I want you to go there for a check-up next week.
It sente kode katkene ôd lao se tais?	Do you feel well enough to travel?
It ên tel sôp ai-moruk kontra malária mola It ma Timor?	Did you take a malarial prophylaxis (preventative) before coming to Timor?
Ai-moruk sapa pe doutór né lao It?	Which prophylaxis did your doctor prescribe?
Ra klorokina ka?	Was it chloroquin?
Kuidadu nam bae pe It ên.	Be careful what you drink.
Pôs kininu kid lao er rai mola It hana ên.	Put one of these water-purifying pills into the water you drink.
It ên lia er nei botir.	Drink only bottled water.
Non er rat minutu lim arpi' l It hana ên er ta.	Boil all water for at least five minutes before you drink.
Arpi' l It hana ên kafé nor xa It tenke pei katak er ta nakali dlo.	When you drink tea and coffee make sure that the water is fully boiled.
Baléb pôs jelu nei It enu ta.	Don't have ice in your drinks.
Baléb mua salada bae pe has nor er-torneira.	Don't eat any salad that has been washed in tap water.
Arpi' l pontu sêrgia sai tel ôs It eta- lolo?	When did these spots first appear?
Deskulpa, semén It pun kontaktu seksuál arpi' l It ma nei Timor?	Have you had sexual relations with any person since you came to Timor?
(nei It rae?)	(in your own country?)
It baléb pun loi kontaktu seksuál.	You must not have any more sexual relations.
It ma lelbán têl loi, mendá para au ôd pun loi tratamentu.	Come back in three days' time so I can examine you again.
Baléb hela hela agi nei lei.	Don't stay in the sun.
Tá It ulu arpi' l It sai la hoh.	Cover your head whenever you go outside.
Au leb pun viajen arpi' l au moras kek mendai?	Can I travel in this condition?
Au leb kontinua viajen rai?	Can I continue the journey?
Hati laularán nei doutór ka?	Is there a doctor in that place?
Agora au sente kode paglau.	I'm feeling better now.
Au sente klao paglau.	I'm feeling worse.
Au sei tusan It pil, Senór Doutór?	How much do I owe you, Doctor?
(Senora Doutora?) It ba presiza sêl agora.	You don't need to pay now: I'll send a bill.
Ba presiza sêl.	There is no charge.
Obrigadu niri, Senór Doutór (Senora Enfermeira).	Thank you for your help, Doctor (Sister).
Favór It prepara reseita rai ma au.	Please fill this prescription for me.
Arpi' l ai-moruk ta leb prontu?	When will the medicine be ready?
Au eta-rua (au bai).	I am pregnant.
Au moras-hulai mededa.	I have strong period pains.
Au ba et hulai hei.	My period did not come this month.
Au hanoin au eta-rua (au bai).	I think I may be pregnant.
It hana medei ap.	You are expecting a baby.
Arpi' l men It leb medei ap? (Arpi' l men leb mori?)	When is the baby due (to be born)?
Au hakarak nei ana mais au ba leb bai.	I want to have a baby but I cannot conceive.
Artúb seri né ai-moruk ne sa It para balikan et ana sôp?	Has anyone given you pills or an injection to make you stop having babies?
It moras arpi' l It bai?	Were you sick while you were pregnant?
It sente kanotak-moras sôp ne hei?	Have your contractions begun?
Partu bebé kode ne bakode?	Did the baby have an easy or a difficult birth?
It tenke ôd bebé lao kliniku ôd konsulta semana-semana.	You must bring the baby to the clinic for a check up every week.
Bebé sarán tel sôp ne hei?	Has the baby been baptized yet?
It hakarak au hah padre?	Do you want me to call a priest?
Arpi' l au leb sak dentista?	When can the dentist see me?
Au nipa moras.	My tooth is aching.
Au nipa xumbu kid mou-lako.	I have lost a filling.
Au gugu en mêt.	My mouth is all infected.
Au hanoin katak au nipa-sua.	I think it is my wisdom teeth.
It leb pôs anestezia (ai-moruk pun lako moras)?	Can you please give me an anaesthetic?
Au hei sa It.	I will give you an injection.
Au tenke asai tel nipa rai.	I must pull out this tooth.
Au boi It asai nipa rai.	I don't want my tooth extracted.
Nipa rai presiza sul tel nor xumbu.	This tooth needs a filling.
Rai moras.	That hurts!
Rai badún moras.	It won't hurt much.
Au tenke broka It nipa.	I must drill your tooth.
It ên bal er rai, mais baléb mod.	Please drink some of this water, but don't swallow.
Hakmúm er nei It gugu, depois tulaba tel.	Roll the water around in your mouth, then spit everything out.
Nipa-sia moras.	The gum is very sore.
Nipa-sia lar.	The gums are bleeding.
It leb mua nor nipa seri rat oras limnainide.	You must not eat on this side of your mouth for six hours.
It baléb ên er brus ne er bisa komesa napai rat ada.	Don't drink anything very cold or very hot until tomorrow.
Se pei men moras, ma sul.	If the tooth hurts again, come back to see me.
Au pun pou tel dentadura rai.	I have broken this denture.
It leb hadia dentadura rai?	Can you repair this denture?
Arpi' l men leb mêt?	When will it be ready?
Leb It hadia?	Can you repair them for me?
Leb It troka lente?	Can you change the lens?
Leb It ne reseita ókulu meta lel-tia ni?	Can you prescribe new sunglasses for me?
Arpi' l men loja lae nor tá?	What time do the shops here open and close?
Loja ga tá nei meiudia?	Do the shops close for lunch?
Leb au sêl nor dolar austrálianu (amerikanu)?	Can I pay for things in Australian (US) dollars?
Leb au sêl nor kartaun-kréditu nei loja rai?	Can I pay with my credit card in this shop?
Loja sebi paglau herbae?	Where is the nearest shop?
Au tenke al ...	I must buy ...
It glae nam hana al?	May I help you, Sir/Madam?
Sin, favór id.	Yes, please.
Au glae ...	I am looking for ...
Au pei lia naha gia.	I am just looking around.
Leb It ajuda au?	Can you help me?
Au hakarak ...	I'd like a ...
It leb tabár...kek?	Can you show me some ....?
Rai tou menbae?	What does this mean?
Leb It tabár id hanesa mêt laularán?	Can you show me one of those?
Au gosta loba (tu).	I want something smaller (larger).
Au gosta id baratu paglau.	I want something cheaper.
Ra karu demais.	This costs too much.
Leb It hatún folin?	Can you lower the price?
Leb It pun deskontu?	Can you give me a discount?
Au glae prezente seri.	I am looking for a gift.
It rekomenda nam baeid au leb ôd sul lao au rae?	What do you recommend to take back to my country?
Rai pun nor lima.	This is hand-made.
Rai pun nei fábrika.	This is factory-made.
Au ba leb al rai dêsni estadu Novazelándia bandu.	I can't buy this because of customs restrictions when I go home to New Zealand.
It nei kasete (sedé) kantadór gala ...	Do you have a cassette (CD) of a singer called ....
Leb It lae múzika rai ma au?	May I listen to this music?
It nei loi kasete nor kantadór bae pe hanesa?	Do you have other cassettes of the same singer?
Au hakarak al kasete múzika Timor.	I'd like to buy some cassettes of Timorese music.
It sio mêt video-kasete?	Do you sell videos also?
It nei livru hakerek nor mambae?	Do you have any books in Mambai?
It sio livru ka jornál ingles?	Do you sell English books or newspapers?
Au glae mapa kode nor dambát Timor Lelsae ni.	I would like a good road map.
It sio livru Timor nor figura kapás?	Do you sell books about East Timor with nice pictures?
Nam gia pun nei Timór?	Do you have anything made
It nei nam seri pun ôs ai-kameli?	from sandalwood?
Leb It tabár hena selu?	Can you show me other kinds of cloth?
Leb au pei It katálogu?	May I see your catalogue?
Leb It tad nam rai au al nei bae?	Do you know where I can buy that thing?
It sio nam gia Timór pun nor lima?	Do you sell Timorese handicrafts?
(salenda, tais-ana?)	decorative cloth?)
It mêt sio nam boneka lao an- kate?	Do you sell toys (dolls) for children?
Taisid, au ba gosta.	No, I don't like it.
Rai balós nam bae pe au hakarak.	It's not exactly what I want.
Au tenke hanoin en-lao rai.	I must think about it.
Molopei au ma sul.	I might come back another time.
Ra didi lia men au gio.	This is just what I want.
Au al.	I will take it.
Au hei al lim.	I will take five of these.
Leb It bil nei nam id?	Can you wrap these please?
Leb It bil livru rai lao prezente?	Can you wrap this book as a gift?
Favor hasai tel surat-nora folin.	Please take off the price-tag.
Nam gia am sio tel mêt, mais am hei hameno id ma It.	We are out of stock, but we can order the product for you.
Lelbán pil ma rai?	How long will it take to arrive?
Nei semana id nei lala.	About one week.
Leb It ne os katkene (men sinál)?	Would you like to place a deposit?
Au hakarak al hur-hur.	I'd like to have it as soon as possible.
Au tenke sim nei tersa dêsni au hana sai ôs Ainaru.	I must have it by Tuesday because I am leaving Ainaro.
Leb It haruka lao au diresaun nei Austrália?	Can you send it to my address in Australia?
Favor It bil pun kod-kod.	Please wrap the parcel carefully.
Leb It lui nei kaixote?	Can you put them into a box?
Leb It né plástiku para au ôd lui nam gia?	Can you give me a plastic bag to put these things in?
Favor It ôd bal nam bae pe bil tel sôp ôd lao karreta.	Please help me carry packages to the car.
Leb It haruka tio otél? (au diresaun rai?)	Can you send it straight to my hotel (to this address)?
Au leb sêl xeke?	Can I pay with a personal cheque?
Deskulpa, am sim lia os tema.	We are sorry, we accept only cash here.
Leb It né ma au nota kompras?	May I have a receipt, please?
It gio nam selu loi?	Do you want anything else?
Taisid, obrigadu.	Nothing, thank you.
Au hakarak né sul mákina- fotografia rai dêsni nam seri ba dlo.	I want to return this camera . It's faulty.
Leb It troka sul kode kid?	Can you change this for a better one, please?
Au hakarak hua sul osa.	I'd like a refund.
Nota- kompras pe rai.	Here is the receipt.
Deskulpa, Senór!	We are very sorry, Sir!
Ba nei nam id.	It doesn't matter.
It nei seri loi mais koloridu selu?	Do you have the same thing in a different colour?
It gosta koloridu sapa?	What colour would you like?
It sio mera? (moro, gemé, korderoza, meta, kor ahahe?)	Do you have a red (green, blue, yellow, pink, black, white, multicoloured) one?
It nei kor azúl eskuru (azúl klaru)?	Do you have a darker (lighter) shade of blue?
It nei nam-eta kid nor (banór) dezenu?	Do you have a cloth with (without) patterns?
Au hakarak id lao ôd enfeita saia rai.	I want something to match skirt.
It nei id lao náilon (abas)?	Do you have the same thing in nylon (cotton)?
Hena rai nam bisa ni ne rae brusi ni?	Is this material hot or cool?
Au gosta mahar (hilire).	I'd like a thicker (a thinner) material.
Har rai pun ôs sapid?	What is this shirt made of?
Har rai pun nei Timor?	Is this shirt made here in Timor?
Taisid, rai ôs Bali.	No, it comes from Bali.
Au glae har lao an-kate (lao artúb eta-tu, bui-hine eta-mruma).	I'd like a shirt to fit a child (a big man, a thin woman).
Leb It sukat bal au?	Can you measure me, please?
Au presiza tu (loba) katkene.	I need a bigger (smaller) size?
Nei rai alfaiate pe pun nam-eta?	Do you have a tailor/ dressmaker here who makes clothes to measure?
Fatu par id folin pil?	How much would a suit (a dress) cost?
Sor kamiza kid a lelbán pil?	How long does it take to make a shirt?
Au pei rasik hena.	I will choose the material myself.
Kalsa rai presiza pun bada (pun mulua) nei rai.	These trousers need to be . brought in (taken out) here.
Hati troka herbae?	Where is the fitting room?
Rai natón dlo (badún kode, klao paglau).	This fits very well (not so well, badly).
Au tenke kok selu loi.	I must try another size.
Kor rai ba a nor au.	This colour does not suit me.
Au sente rai serve dlo ma au.	This size feels very comfortable.
Pei kode?	How does it look?
Sin . It pei kode dlo.	Yes, it looks very smart on you.
Au númeru sapatu ...	My shoe-size is ....
Sapatu rai aperta demais.	These shoes are too tight.
It nei sapatu kulit ni?	Do you have strong leather shoes?
It nei sapatu kode ôd lolai?	Do you have comfortable shoes for walking?
Po gia folin pil?	How much do these mangoes cost?
Id pil?	How much for one?
(Têl pil?)	(for three?)
Au pun hua limnairua.	I'll take seven of them, give me good ones.
Favor It lui nei plástiku (bornál) rai.	Please put them in a plastic bag (in this bag).
It sio nam nei merkadu nei lelbán sapa lia?	On what days do you sell your wares in the market?
Am sio basar nei domingu.	We hold the market on Sundays only (every Thursday).
Ai-hua rai fresku ka?	Is this fruit fresh?
Folin karu klao.	The price is too high: I will look somewhere else.
Au pun man-telo sagúl-resi-rua.	All right, I will buy a dozen eggs.
Nei hati seri para au ôd kok bal nam-eta rai?	Is there a place where I can try on this dress?
It né sal os-troka.	You made a mistake with the change.
It né loi mu sagúl.	Please give me ten more bananas.
Baléb obriga, au ba al rai.	Don't insist: I do not want to buy this.
Au hakarak tiba karta rai lao Novazelándia.	I'd like to send this letter to New Zealand.
Nor aviaun ne ro-tasi?	By airmail or seamail?
Favor né au selus limnainide para haruka karta lao Darwin.	Please give me six stamps for letters going to Darwin.
Favor né au adezivu para au ôd né tom aviaun.	Please give me some airmail stickers.
Karta sêrgia né tom aviaun?	Do all letters go by airmail?
Au hakarak haruka surat rai ôs espresu.	I want to send this letter express
Au hakarak nam-bila rai lao Austrália.	I want to send this package to Australia.
Lao Austrália herbae dlo?	To where in Australia?
Lao Adelaide.	It is going to Adelaide.
Lelbán pil men rat laularán?	How long will it take to arrive?
Au leb ne seguru?	Can I insure it?
Seguru pil?	How much does the insurance cost?
Favór id prepara orden postal en- lao rupia ...	Please make me out a money order for R ....
Leb It troka orden postál rai?	Can you change this money order?
It nei karta ma au ga?	Is there any mail for me, please?
Au gala ....	My name is ..
"Favór It hakerek kuidadu ""tio nor kuidadu"" nor portugés nei falun rai."	Please write 'handle with care' in Portuguese on the package.
It presiza prenxe formuláriu rai.	You need to fill out this form.
Falun rai nei sapid?	What does the packet contain?
Nei livru nor nam-eta lia.	It has books and clothes only.
Leb It né ma au resibu?	May I have a receipt?
Leb haruka faks ôs uma-korreiu rai?	Can I send a fax from this post-office?
Leb telefone ôs rai lao hoh?	Can I make an overseas phone- call from here?
Artúb Timor bae pe tu nei direitu para tom vota.	Every adult citizen of East Timor has the right to vote.
Para It leb vota, It tenke prenxe kartaun-rejistu kid.	To vote, you must fill in a voter registration card.
It vota rai importante . Dês ra, hanoin men leb tom.	Your vote is important, so think carefully about what you choose.
Lei bandu artúb para baléb obriga artúb selu ôd tom urá ni hakarak.	It is against the law for anyone to force you to vote for something you don't want.
It livre para It leb tom vota tuir nam bae pe It gio.	You are free to vote according to your own will.
Vota rai segredu.	The ballot is secret.
Artúb selu ba tad sapid pe It tom.	Nobody will know how you voted.
Se artúb seri obriga It para tom urá ni hakarak, kesar hur-hur lao ofisiál eleitorál id.	If anyone tries to force you to vote against your will, you must report this to an electoral officer.
Se It hakarak tom., hakerek krus nei hati kid rai.	If you wish to vote for, put a cross in this box.
It tenke ôd kartaun rai arpi' l It hana lao vota.	You must take this card with you when you go to vote.
Semén It prenxe, It lui nei kaixa kid-laularán.	When you have filled the form, put it in the ballot-box.
Semén It tom tel sôp, balikan tou sai artúb id nam bae pe It vota.	Before and after you vote, it is best not to tell other people your choice.
Balikan tamau.	Don't be afraid.
Am nei rai para ajuda It.	We are here to help you.
Au badún komprende It dêsni au artúb malae.	I cannot understand you very well because I am a foreigner.
Gase hel-hel para au ôd komprende	Try to speaks slowly so that I can understand you.
Pun favór tou nam haigia-mêt lao durubasa.	Please tell everything to the interpreter.
Baléb sero.	Don't cry.
Kalma katkene.	Try to be calm.
Se It kalma, It leb hanoin kode paglau.	If you are calm, you will think better.
Se It kalma am leb ajuda It.	If you are calm, we can help you better.
Pun favór medei nei rai.	Please sit here.
It hakarak enu er brus?	warm to drink first?
Se artúb selu pun klao, It tenke tou sai am.	If somebody hurt you, you must tell us.
Artúb baeid pe ra mêt ba nei nam id.	It doesn't matter who that person was.
Nam bae pe It tou sai am ra, am tá tel.	Everything you tell us will be in strict confidence.
It tenke tou mêt nam bae pe It tad.	You must tell us everything.
Rom ba glae nam bae pe It tou sai am.	They will not find out what you told us.
Nei sapid?	What is the matter?
Sapid pe akontense lao It?	What happened to you?
Sen pe pun nam ra lao It?	Who did this to you?
It tad artúb bae pe ataka It?	Do you know the name of the person who attacked you?
Urá artúb ôs bae?	Where does he come from?
Urá hela herbae?	Where does he live?
Leb It identifika artúb bae pe dae It?	Can you identify the people who hurt you?
Rom artúb Timor ga artúb ma ôs hoh?	Are they East Timorese or foreigners?
Rom ôs grupu paramilitár (milisia)?	Do they belong to a para- military group?
Grupu baeid?	Which group?
Rom ulun pe sen?	Who is their local leader?
Rom dae It?	Did they beat you?
Rom ameasa It nor ter-hua?	Did they threaten you with words?
Urá tou sapid?	What did he say?
Dêssapid rom ataka It?	Why did they attack you?
Rom glo-hakarak sapid ôs It?	What did they want from you?
It tad artúb ra arpil?	How long have you known that person?
It kesar lao polisia?	Did you report it to the police?
(tropa ni ulun? Krus Vermella, padre sêrgá?)	(army officers, Red Cross, the priests?)
It kesar kazu rai lao sen?	Whom did you report the crime to?
Artúb rai tou sapid lao It?	What did that person tell you?
Rai dlo ne tais?	Is this true?
Artúb sêrgia gase doha en-lao au.	Those people told lies about me.
Sem pe et, arpila rom ataka It?	Who saw them attack you?
Rom obriga It para lao put nor rom?	Did they force you to go with you?
Rom kode la It, ne rom pun It tamau?	Were they polite to you, or did they try to frighten you?
Rom akuza en-lao sapid?	What did they accuse you of?
Rom ameasa It?	Did they threaten you?
Rom lima en It?	Did they touch you?
Rom dae It?	Did they beat you?
Rom ne It nam-á nor era?	Did they give you food and drink?
Rom lop It lao sak familia?	Were you allowed to see your family (the priest, lawyer)?
Rom tou sai It familia katak rom prende It?	Was your family notified that you were detained?
Rom tou dêssáp rom prende It?	Did they tell you why you were detained?
Lelbán pil rom lui It nei hati ran?	How long did they keep you in that place?
Rom violenta It seksualmente?	Did they sexually assault you?
Polisia (tropa) ni ulun tad problema rai?	Does the local police-officer (military commander) know about these matters?
Arpil men It ana ta lako?	When did your son disappear?
It kesar tel sôp lao polisia?	Did you report his disappearance to the police?
Artúb seri et urá?	Has anyone seen him since?
It glae nei bae dlo?	Where have you looked for your son?
It urá lako dêssáp?	Do you think there is a reason why he disappeared?
Urá nei tel sôp problema antes?	Had he been in trouble before?
It kaben nei kadeia?	Is your husband in prison?
It tad nei kadeia bae dlo?	Do you know which prison?
It leb vizita urá?	Have you been able to visit him?
Urá eta-kode?	Is he in good health?
Urá tou sapid arpil It lao vizita?	What did he tell you when you visited him?
Arpi' l men It kaben ni prosesu komesa?	When will your husband's trial be held?
Rom akuza urá dêssáp?	What are the charges against him?
Urá nei advogadu ôd defende urá?	Does he have a lawyer to help him?
It tou It kaben ni problema lao sen?	Whom have you told about his imprisonment?
Leb It gine fotografia It ana-hine ta ni?	Can you show me a photo of your daughter?
Urá gala bae?	What is her name?
Leb It esplika urá ni feitiu mensapa?	Can you describe her to me?
Urá-ni oe-naru ne bada?	Is she tall or short?
Urá-ni naru rat bae?	How tall is she?
Urá-ni ulu mensapa?	What kind of hair does she have?
Urá bokur ne mruma?	Is she stout or thin?
Sen pe ma tom et urá?	Who was the last person to see her?
Favór It hakerek mêt nam bae pe en-lao problema rai.	Please write down everything you know about this case.
Am hakarak tou sai lao Krus Vermella.	We will report this to the Red Cross.
Am hei tou sai It arpi' l am tad nam id.	We will inform you as soon as we learn something.
Am sente triste dlo dês sapid pe akontese lao It.	We are very sorry about what happened.
Am hei pun menbae paraôd ajuda It.	We will do everything possible to help you.
Au mêt nei familia kid men It.	I have a family just like you.
Au tad sapid pe It sente.	I understand how you feel.
It tamau hela nei uma?	Are you afraid to stay at home now?
It hakarak au glae hati la It hela?	Do you want me to find you somewhere safe to stay?
It ma put nor am: It ba leb gnan loi her rai.	Come with us: you can't stay here any longer.
Laularán nei azár.	There has been an accident.
Karreta rua hai lor.	Two cars crashed.
Karreta hai xoke ai-pu kid.	The car crashed into a tree.
Karreta plar sai ôs dambát.	The car ran off the road.
Karreta ra met xoke artúb id lolai oe.	A pedestrian has been run over by a car.
Nei artúb seri huga?	Is anyone hurt?
Balikan dlai.	Don't move!
Kode.	It's all right.
Balikan tamau.	Don't worry.
Sokorru ma agora.	Help is on the way.
Artúb huga nei karreta lala?	There's someone hurt in this car.
Lao hur-hur ôd ajuda.	Please go and get help.
Lao telefone ôd tug ajuda.	Please go and telephone for help.
Hur-hur, hah doutór!	Please get a doctor, quickly!
Nei artúb huga tu.	There are people badly injured here.
Ajuda au hasai ôs karreta.	Help me get them out of the car.
Ma ajuda au fila karreta.	Help me turn the car over.
Hairá tio mêt!	Everyone: lift now!
Hur-hur, hah polisia!	Please call the police immediately.
Tug rom né karreta-ambulánsia.	Ask them to send an ambulance.
Hua nam id ôd tá tel urá-ni huga.	Get something to bandage this wound.
Urá-ni lar sai niri.	He is losing a lot of blood.
Grasa Maromak It rat ma!	Thank God you've arrived!
Artúb ra tenke lao lia ospitál.	This person must go straight to hospital.
Rai urjente.	It's urgent.
Favór id tou sai urá-ni familia.	Please inform his family.
Urá presiza transfuzaun lar ni.	He needs a blood transfusion.
Pun favór It ma pei nudar testemuna.	Would you please come and act as a witness?
Senora Enfermeira, favor id hah doutór ma.	Nurse, please get the doctor.
Au moras.	I am in pain.
Leb It né nam-á ma au mua nor enu?	May I please have something to eat (to drink)?
Au presiza lao sentina.	I need to go to the toilet.
Favor id ôd tio hati sok-era ni.	Please bring me a pot (to go to the toilet).
Favor id troka lensól.	Please change the sheets.
Rom foer tel sôp.	They are dirty.
Favor id troka bal au xumasu dêsni nei lar.	Please change my pillow.
Au lar sai.	There is blood on it.
Au ba leb boe dêsni bohaha demais.	I am bleeding.
Au brusi demais.	I can't rest because there is too much noise.
Au kosar.	I am very hot.
bakbako.	I am sweating all the time.
Leb It lui au nei hati kalma kid?	Is it possible to put me in a quieter room?
Boe hati rai badún kode kid.	This bed is very uncomfortable.
Favor id ôd surat-nora nor lapizeira para au ôd hakerek.	Please bring me paper and a pen so I can write a letter.
Au hei hela nei ospitál lelbán pil loi, Senór Doutór?	How long must I stay in hospital, doctor?
It tenke hela semana kid nei rai.	You must stay here for one more week.
Au kode katkene ka?	Am I getting better?
It kondisaun kode katkene.	Your condition is gradually improving.
Au tenke sa It hat id loi.	We must give you another injection.
Favor It fila, para au ôd sa It.	Please turn over so that I can give you the injection.
Ada It muda lao kuartu selu.	We will transfer you to another ward tomorrow.
Au hana vizita Senór X pe baixa nei ospitál rai.	I want to visit Mr. X. who is in this hospital.
Urá nei kuartu sapa?	In what room is he?
Favór hati pe baeid?	Which way, please?
Leb au vizita urá agora?	Can I visit him now?
Deskulpa, ba leb.	No, I'm sorry.
It tenke ma sul nei oras vizita ni.	You must come back during visiting hours.
Arpi' l men au leb vizita urá?	When can I visit him?
Nei tuku rua nor tuku lim ni lala.	Between two and five o'clock.
Senór (senora) rai gio vizita urá-ni sao.	This lady (gentlemen) wishes to visit his relative.
Doutór sen pe pei au amigu ta?	Which doctor is looking after my friend?
Leb au gase lao doutór?	May I speak to the doctor?
Nei rai nei soldadu?	Are there any soldiers around here?
Rom ubu-pil?	How many of them are there?
Rom ma ôs rae bae?	What nationality are they?
Rom farda kor sapa?	What colour is their uniform?
Nei kilat artillaria pil?	How many artillery pieces are there?
Nei metralladora pil?	How many machine-guns are there?
Nei tankedegerra pil?	How many tanks are there?
Nei aviaun pil?	How many planes are there?
It leb deskreve aviaun ni dezenu pil?	Can you describe the aircraft markings?
Men rai?	Were they like this?
Leb It pinta nam ra la au?	Can you draw a sketch for me?
Nei larán ....	Are there any ...
... kampu aviaun ni	... airfields
... hati ôd lui kilat nor munisaun	... arms and ammunition dumps
... sentru mensajen ni	... message centres
... rae nei minas	... mine fields
... fortifikasaun simentu armadu	... pillboxes
... estasaun rádiu ni	... radio stations
... sentru distribuisaun	... supply depots
... fiu-telefone?	... telephone lines?
Tropa sêrgá nei ...	Do the troops have ...
... kilat anti-tanke	... antitank guns
... artillaria jipe	... artillery
... motor (motorizada)	... jeeps...motorcycles
... aviaun	... aeroplanes
... apetrexus	... supplies
... tanke	... tanks
... kamiaun	... trucks?
Tropa rom ...	Have the troops been ...
... ma ahe?	... advancing?
... lao hoho?	... retreating?
... ke rae?	... digging trenches?
... lui minas?	... laying mines?
... pun kampu aviaun?	... preparing an airfield?
... lui suprimentu?	... storing supplies?
... hadia ekipamentu?	... repairing equipment?
... pun armadilla lao tanke?	... building tank traps?
... ke abrigu nei rae sua?	... building dugouts?
Soldadu sêrgá lao herbae?	Which way did the soldiers go?
Rom lui tel minas seri sôp?	Have they planted any mines?
Tabár ma am rom herbae.	Show us where they are.
Gnan nei rai.	Wait here.
Mri.	Stand up.
Lolai ma.	Come forward.
Lao hoho.	Move back.
Fila.	Turn around.
Lao dlo.	Go ahead.
Avante lao ahe.	Advance.
Tom au.	Follow me.
Ma nor au.	Come with me.
Lao hel-hel.	Go slow.
Hur-hur.	Hurry.
Para.	Stop.
Para.	Halt.
Sen pe laularán?	Who goes there?
Balikan tiru.	Don't shoot.
Hatún tel katan ta.	Put down your machete.
Hatún kilat.	Put down your gun (s).
Hasae lima.	Raise your hands.
Balikan dlai.	Don't move.
Balikan tamau.	Don't be afraid.
It tad hati rai?	Are you familiar with this area?
Rae rai mensapa?	What kind of terrain is it?
Rai foho-ana / rae-udu / tetuk?	| $it hilly mountainous / flat?
It toma salolo rai?	Are you familiar with this road?
It tad salolo lao Suai?	Do you know the road to Suai?
Salolo rai menbae?	What is the road's condition?
Kode / klao/ alkatraun?	... good bad / sealed?
Salolo (dambát) ta tel nor egor.	The road is covered with sand.
Dambát hei mo nei semana rai.	It will be cleared this week.
Parte kid rai mes hat dlo.	This section is a gravel road.
Parte kid rai alkatraun ba nei.	This section is unsealed.
Kondisaun dambát rai ba tad hei.	The condition of this road is not known.
Dambát rai tutan lao Maubisi Turiskai.	This road connects Maubisse with Turiscai.
Ro pil ôs Ainaru lao fronteira?	How far is it from Ainaro to the border?
Kala kilómetru sagúl-resi-lim.	The road divides approximately 20 km.
Dambát rai hae rua kala kilómetru hatrua súl Dili.	south of Dili.
Dambát rai hahú ôs norte lao súl.	The road runs from north to south.
Dambát rai hahú ôs este lao ueste.	This road runs from east to west.
Dambát rai lao dlo rat fronteira.	This road continues as far as the border.
Kode paglau It ôd roda-rezerva resin.	You'd better take an extra spare wheel with you.
It nei kaixa bes kode lao karreta?	Have you got a good tool-kit?
It ôd er lao ên ka?	Do you carry a drinking-water supply?
Previzaun-tempu menbae?	What's the weather forecast?
Tempu hana sai kode / klao.	The forecast is good / bad.
Rom prevé ...	They forecast ...
us / tempestade /rae-lio/ gel tu.	... rain / a storm / lightning / high winds
Nei minas seri nei salolo?	Are there any mines on the road?
Nei minas her uma lala?	Are there any mines in the building?
Minas mensapa ni?	What sort of mines are they?
Rae nei minas marka tel sôp?	Are the minefields marked?
Tiru herbae?	Where is the shooting?
Sen pe pôs?	Who is shooting whom?
Hana lao ran lao seguru ne tais?	Is it safe to go there?
Nei bae pe hati susar ni?	Where are the trouble-spots?
Nei susar niri nei hati kid rai.	There's a lot of trouble in this area.
Sapid pe pun hati ra ba hakmatek?	What are the causes of the unrest?
Am ba tad.	We don't know.
Sentidu!	Attention!
Deskansa!	Stand at ease!
Mata lao ahe!	Eyes front!
Mata lao dlo/toi karuk.	Eyes right/left!
Fila lao dlo/karuk!	Right/left turn!
Ne volta lao dlo/karuk.	Right/left incline!
Marxa hur-hur!	About turn!
Lolai lao ahe hur- hur!	Fall in!
Marxa hel-hel!	Quick march!
Lolai hel-hel!	Slow march!
Para!	Halt!
Hae la lor!	Dismiss!
Karrega/hatama kartuxeira!	Load!
Deskarrega/asai kartuxeira!	Unload!
Kartuxeira mamu!	Empty magazine!
Dad kulatra!	Action!
Prontu!	Instant!
Pei nor pôs (tir)!	Watch and shoot!
Pôs (tir)!	Fire!
Revista kilat!	Reholster!
Sobu kilat!	Inspect weapons!
Arma kilat!	Strip weapons!
Monta kilat!	Assemble the weapon!
Tio kilat!	Pick up weapons!
